							 e  t  e  e  t  e  e  t  e  e  t  e  e  t  e  e  t  e  e  t  e  e  t  e  e  t  e  e  t  e  e  t  e  e  t  e  e  t  e  e 
							 e  e  e  e  e  e  e  e  e  e  e  e  e  e  e  e  e  e  e  e  e  e  e  e  e  e  e  e  e  e  e  e  e  e  e  e  e  e  e  e 
							 t  e  e  e  e  e  e  e  e  e  e  e  e  e  e  e  e  e  e  e  e  e  e  e  e  e  e  e  e  e  e  e  e  e  e  e  e  t  e  e 
							 e  e  e  e  h  e  e  e  e  e  e  e  e  e  e  e  e  e  e  e  e  e  e  e  e  e  e  e  e  e  e  e  e  e  e  e  e  e  e  e 
							 t  e  e  e  e  e  e  e  e  e  e  e  e  e  e  e  e  e  e  e  e  e  e  e  e  e  e  e  e  e  e  e  e  e  e  e  e  e  e  e 
							 e  e  e  e  e  d  e  e  e  e  e  e  e  e  e  e  e  e  e  e  e  e  e  e  e  e  e  e  e  e  e  e  e  e  e  e  e  e  e  e 
							 t  e  e  e  e  e  e  e  e  e  e  e  e  e  e  e  e  e  e  e  e  e  e  e  e  e  e  e  e  e  e  e  e  e  e  e  e  e  e  e 
							 e  e  e  e  e  e  e  e  e  e  e  e  e  e  e  e  e  e  e  e  e  e  e  e  e  e  e  e  e  e  e  e  e  e  e  e  e  e  e  e 
							 t  e  e  e  e  e  e  e  e  e  e  e  e  e  e  e  e  e  e  e  e  e  e  e  e  e  e  e  e  e  e  e  e  e  e  e  e  e  e  e 
							 e  e  e  e  e  e  e  e  e  e  e  e  e  e  e  e  e  e  e  e  e  e  e  e  e  e  e  e  e  e  e  e  e  e  e  e  e  e  e  e 
							 t  e  e  e  e  e  e  e  e  e  e  e  e  e  e  e  e  e  e  e  e  e  e  e  e  e  e  e  e  e  e  e  e  e  e  e  e  t  e  e 
							 e  e  e  e  e  e  e  e  e  e  e  e  e  e  e  e  e  e  e  e  e  e  e  e  e  e  e  e  e  e  e  e  e  e  e  e  e  e  e  e 
							 t  e  e  e  e  e  e  e  e  e  e  e  e  e  e  e  e  e  e  e  e  e  e  e  e  e  e  e  e  e  e  e  e  e  e  e  e  t  e  e 
							 e  e  e  e  e  e  e  e  e  e  e  e  e  e  e  e  e  e  e  e  e  e  e  e  e  e  e  e  e  e  e  e  e  e  e  e  e  e  e  e 
							 t  e  e  e  e  e  e  e  e  e  e  e  e  e  e  e  e  e  e  e  e  e  e  e  e  e  e  e  e  e  e  e  e  e  e  e  e  t  e  e 
							 e  e  e  e  e  e  e  e  e  e  e  e  e  e  e  e  e  e  e  e  e  e  e  e  e  e  e  e  e  e  e  e  e  e  e  e  e  e  e  e 
							 t  e  e  e  e  e  e  e  e  e  e  e  e  e  e  e  e  e  e  e  e  e  e  e  e  e  e  e  e  e  e  e  e  e  e  e  e  t  e  e 
							 e  e  e  e  e  e  e  e  e  e  e  e  e  e  e  e  e  e  e  e  e  e  e  e  e  e  e  e  e  e  e  e  e  e  e  e  e  e  e  e 
							 t  e  e  e  e  e  e  e  e  e  e  e  e  e  e  e  e  e  e  e  e  e  e  e  e  e  e  e  e  e  e  e  e  e  e  e  e  t  e  e 
							 e  e  e  e  e  e  e  e  e  e  e  e  e  e  e  e  e  e  e  e  e  e  e  e  e  e  e  e  e  e  e  e  e  e  e  e  e  e  e  e 
							 t  e  e  e  e  e  e  e  e  e  e  e  e  e  e  e  e  e  e  e  e  e  e  e  e  e  e  e  e  e  e  e  e  e  e  e  e  t  e  e 
							 e  e  e  e  e  e  e  e  e  e  e  e  e  e  e  e  e  e  e  e  e  e  e  e  e  e  e  e  e  e  e  e  e  e  e  e  e  e  e  e 
							 t  e  e  e  e  e  e  e  e  e  e  e  e  e  e  e  e  e  e  e  e  e  e  e  e  e  e  e  e  e  e  e  e  e  e  e  e  t  e  e 
							 e  e  e  e  e  e  e  e  e  e  e  e  e  e  e  e  e  e  e  e  e  e  e  e  e  e  e  e  e  e  e  e  e  e  e  e  e  e  e  e 
							 t  e  e  e  e  e  e  e  e  e  e  e  e  e  e  e  e  e  e  e  e  e  e  e  e  e  e  e  e  e  e  e  e  e  e  e  e  t  e  e 
							 e  e  e  e  e  e  e  e  e  e  e  e  e  e  e  e  e  e  e  e  e  e  e  e  e  e  e  e  e  e  e  e  e  e  e  e  e  e  e  e 
							 t  e  e  e  e  e  e  e  e  e  e  e  e  e  e  e  e  e  e  e  e  e  e  e  e  e  e  e  e  e  e  e  e  e  e  e  e  t  e  e 
							 e  e  e  e  e  e  e  e  e  e  e  e  e  e  e  e  e  e  e  e  e  e  e  e  e  e  e  e  e  e  e  e  e  e  e  e  e  e  e  e 
							 t  e  e  e  e  e  e  e  e  e  e  e  e  e  e  e  e  e  e  e  e  e  e  e  e  e  e  e  e  e  e  e  e  e  e  e  e  t  e  e 
							 e  e  e  e  e  e  e  e  e  e  e  e  e  e  e  e  e  e  e  e  e  e  e  e  e  e  e  e  e  e  e  e  e  e  e  e  e  e  e  e 
							 t  e  e  e  e  e  e  e  e  e  e  e  e  e  e  e  e  e  e  e  e  e  e  e  e  e  e  e  e  e  e  e  e  e  e  e  e  t  e  e 
							 e  e  e  e  e  e  e  e  e  e  e  e  e  e  e  e  e  e  e  e  e  e  e  e  e  e  e  e  e  e  e  e  e  e  e  e  e  e  e  e 
							 t  e  e  e  e  e  e  e  e  e  e  e  e  e  e  e  e  e  e  e  e  e  e  e  e  e  e  e  e  e  e  e  e  e  e  e  e  t  e  e 
							 e  e  e  e  e  e  e  e  e  e  e  e  e  e  e  e  e  e  e  e  e  e  e  e  e  e  e  e  e  e  e  e  e  e  e  e  e  e  e  e 
							 t  e  e  e  e  e  e  e  e  e  e  e  e  e  e  e  e  e  e  e  e  e  e  e  e  e  e  e  e  e  e  e  e  e  e  e  e  t  e  e 
							 e  e  e  e  e  e  e  e  e  e  e  e  e  e  e  e  e  e  e  e  e  e  e  e  e  e  e  e  e  e  e  e  e  e  e  e  e  e  e  e 
							 t  e  e  e  e  e  e  e  e  e  e  e  e  e  e  e  e  e  e  e  e  e  e  e  e  e  e  e  e  e  e  e  e  e  e  e  e  t  e  e 
							 e  e  t  e  e  t  e  e  t  e  e  t  e  e  t  e  e  e  e  e  e  e  t  e  e  t  e  e  t  e  e  t  e  e  t  e  e  e  e  e 
							 e  e  e  e  e  e  e  e  e  e  e  e  e  e  e  e  e  e  e  e  e  e  e  e  e  e  e  e  e  e  e  e  e  e  e  e  e  e  e  e 
							 e  e  e  e  e  e  e  e  e  e  e  e  e  e  e  e  e  e  e  e  e  e  e  e  e  e  e  e  e  e  e  e  e  e  e  e  e  e  e  e};