sb  sb  sb  sb  sb  sb  sb  sb  sb  sb  sb  sb  e   e   sb  sb  sb  sb  sb  sb  sb  sb  sb  sb  sb  
sb  e   e   e   e   e   e   e   e   e   e   e   e   e   e   e   e   e   e   e   e   e   e   e   sb  
sb  e   e   e   e   e   e   e   e   e   e   e   e   e   e   e   e   e   e   e   e   e   e   e   sb  
sb  e   e   e   so  e   e   e   e   e   e   e   e   e   e   e   e   e   e   sc  e   e   e   e   sb  
sb  e   e   e   e   e   e   e   e   e   e   e   e   e   e   e   e   e   e   e   e   e   e   e   sb  
sb  e   e   e   e   e   e   e   e   e   e   e   e   e   e   e   e   e   e   e   e   e   e   e   sb  
sb  e   e   e   e   e   e   e   e   e   e   e   e   e   e   e   e   e   e   e   e   e   e   e   sb  
sb  e   e   e   e   e   e   e   e   e   e   e   e   e   e   e   e   e   e   e   e   e   e   e   sb  
sb  e   e   e   e   e   e   e   e   e   e   e   e   e   e   e   e   e   e   e   e   e   e   e   sb  
sb  e   e   e   e   e   e   e   e   e   e   e   e   e   e   e   e   e   e   e   e   e   e   e   sb  
sb  e   e   e   so  e   e   e   e   e   e   e   e   e   e   e   e   e   e   so  e   e   e   e   sb  
sb  e   e   e   e   e   e   e   e   e   e   e   e   e   e   e   e   e   e   e   e   e   e   e   sb  
sb  e   e   e   e   e   e   e   e   e   e   e   e   e   e   e   e   e   e   e   e   e   e   e   sb  
sb  sb  sb  sb  sb  sb  sb  sb  sb  sb  sb  sb  e   e   sb  sb  sb  sb  sb  sb  sb  sb  sb  sb  sb  