					e   e   e   e   e   e   e   e   e   e   e   e   e   e   e   e   t   e   e   t   e   e   t   e   e   t   e   e   t   e   e   t   e   e   t   e   e   t   e   e  
					e   e   e   e   e   e   e   e   e   e   e   e   e   e   e   e   e   e   e   e   e   e   e   e   e   e   e   e   e   e   e   e   e   e   e   e   e   e   e   e  
					e   e   e   e   e   e   e   e   e   e   e   e   e   e   e   e   ro  e   e   e   e   e   e   e   e   e   e   e   e   e   e   e   e   e   e   e   e   t   e   e  
					e   e   e   e   e   e   e   e   e   e   e   e   e   e   ro  e   e   e   e   e   e   e   e   e   e   e   e   e   e   e   e   e   e   e   e   e   e   e   e   e  
					e   e   e   e   e   e   e   e   e   e   e   e   e   e   ro  e   e   e   e   e   e   e   e   e   e   e   e   e   e   e   e   e   e   e   e   e   e   t   e   e  
					e   e   e   e   e   e   e   e   e   e   e   e   ro  e   e   e   e   e   e   e   e   e   e   e   e   e   e   e   e   e   e   e   e   e   e   e   e   e   e   e  
					e   e   e   e   e   e   e   e   e   e   e   e   e   e   e   e   e   e   e   e   e   e   e   e   e   e   e   e   e   e   e   e   e   e   e   e   e   t   e   e  
					e   b   e   e   e   e   e   e   e   e   e   ro  e   e   e   e   e   e   e   e   e   e   e   e   e   e   e   e   e   e   e   e   e   e   e   e   e   e   e   e  
					e   e   e   e   e   e   e   e   e   ro  e   e   e   e   e   e   e   e   e   e   e   e   e   e   e   e   e   e   e   e   e   e   e   e   e   e   e   t   e   e  
					e   e   e   e   e   e   e   e   e   e   e   e   e   e   e   e   h   e   e   t   e   e   t   e   e   h   e   e   e   h   e   e   e   e   e   e   e   e   e   e  
					e   e   e   e   e   e   e   e   ro  e   e   e   e   e   e   e   e   e   e   e   e   e   e   e   e   e   e   e   e   e   e   e   e   e   e   e   e   t   e   e  
					e   e   e   e   e   e   ro  e   e   e   e   e   e   e   e   e   e   d   e   e   e   e   e   e   e   e   d   e   e   e   d   e   e   e   e   e   e   e   e   e  
					e   e   e   e   e   ro  e   ro  e   e   e   e   e   e   e   e   e   e   e   e   fl  e   fl  e   fl  e   e   e   e   e   e   e   e   e   e   e   e   e   e   e  
					e   e   e   e   e   e   e   e   e   e   e   e   e   e   e   e   e   e   e   e   e   e   e   e   e   e   e   e   e   e   e   e   e   e   e   e   e   e   e   e  
					e   e   e   e   e   e   e   e   e   e   e   e   e   e   e   e   e   e   e   e   e   e   e   e   e   e   e   e   e   e   e   e   e   e   e   e   e   e   e   e  
					e   e   e   e   e   ro  e   e   e   e   e   e   e   e   e   e   e   e   e   e   e   e   e   e   e   e   e   e   e   e   e   e   e   e   e   e   e   e   e   e  
					e   e   e   e   e   e   ro  e   e   e   e   e   e   e   e   e   e   e   e   t   e   e   e   t   e   e   e   e   e   e   e   e   e   e   e   e   e   t   e   e  
					e   e   e   e   e   e   e   e   e   e   e   e   e   e   e   e   e   e   e   e   e   e   e   e   e   e   e   e   e   e   e   e   e   e   e   e   e   e   e   e  
					e   e   e   e   e   e   e   e   e   e   e   e   e   e   e   e   e   e   fl  e   e   e   e   e   e   e   fl  e   e   e   e   e   e   e   e   e   e   t   e   e  
					e   e   e   e   e   e   e   ro  e   e   e   e   e   e   e   e   h   e   e   e   e   e   fl  e   e   e   e   e   e   h   e   e   e   e   e   e   e   e   e   e  
					e   e   e   e   e   e   e   e   e   e   e   e   e   e   e   e   e   e   e   e   fl  e   e   e   e   e   e   e   e   e   e   e   e   e   e   e   e   t   e   e  
					e   e   e   e   e   e   e   e   e   e   e   e   e   e   e   e   e   d   e   e   e   e   e   e   e   e   e   e   e   e   d   e   e   e   e   e   e   e   e   e  
					e   e   e   e   e   e   e   e   e   ro  e   e   e   e   e   e   e   e   e   e   e   e   e   e   e   e   e   e   e   e   e   e   e   e   e   e   e   e   e   e  
					e   e   e   e   e   e   e   e   e   e   e   e   e   e   e   e   e   e   e   e   e   e   e   e   e   e   e   e   e   e   e   e   e   e   e   e   e   e   e   e  
					e   e   e   e   e   e   e   e   e   e   e   e   e   e   e   e   e   e   e   e   e   e   e   e   e   e   e   e   e   e   e   e   e   e   e   e   e   e   e   e  
					e   e   e   e   e   e   e   e   e   e   ro  e   e   e   e   e   e   e   e   e   e   e   e   e   e   e   e   e   e   e   e   e   e   e   e   e   e   e   e   e  
					e   e   e   e   e   e   e   e   e   e   e   e   e   e   e   e   e   e   e   e   e   e   e   e   e   e   e   e   e   e   e   e   e   e   e   e   e   t   e   e  
					e   e   e   e   e   e   e   e   e   e   e   e   ro  e   e   e   e   e   e   e   e   e   e   e   e   e   e   e   e   e   e   e   e   e   e   e   e   e   e   e  
					e   e   e   e   e   e   e   e   e   e   e   e   e   e   e   e   e   e   e   e   e   e   e   e   e   e   e   e   e   e   e   e   e   e   e   e   e   t   e   e  
					e   e   e   e   e   e   e   e   e   e   e   e   e   e   e   e   e   e   e   e   e   e   e   e   e   e   e   e   e   e   e   e   e   e   e   e   e   e   e   e  
					e   e   e   e   e   e   e   e   e   e   e   e   e   e   e   e   e   e   e   e   e   e   e   e   e   e   e   e   e   e   e   e   e   e   e   e   e   t   e   e  
					e   e   e   e   e   e   e   e   e   e   e   e   e   e   ro  e   e   e   e   e   e   e   e   h   e   e   e   e   e   e   e   e   e   e   e   e   e   e   e   e  
					e   e   e   e   e   e   e   e   e   e   e   e   e   e   e   e   e   e   e   e   e   e   e   e   e   e   e   e   e   e   e   e   e   e   e   e   e   t   e   e  
					e   e   e   e   e   e   e   e   e   e   e   e   e   e   e   e   e   e   e   e   e   e   e   e   d   e   e   e   e   e   e   e   e   e   e   e   e   e   e   e  
					e   e   e   e   e   e   e   e   e   e   e   e   e   e   e   e   e   e   e   e   e   e   e   e   e   e   e   e   e   e   e   e   e   e   e   e   e   t   e   e  
					e   e   e   e   e   e   e   e   e   e   e   e   e   e   e   ro  e   e   e   e   e   e   e   e   e   e   e   e   e   e   e   e   e   e   e   e   e   e   e   e  
					e   e   e   e   e   e   e   e   e   e   e   e   e   e   e   e   e   e   e   e   e   e   e   e   e   e   e   e   e   e   e   e   e   e   e   e   e   t   e   e  
					e   e   e   e   e   e   e   e   e   e   e   e   e   e   e   e   e   e   t   e   e   t   e   e   t   e   e   t   e   e   t   e   e   t   e   e   t   e   e   e  
					e   e   e   e   e   e   e   e   e   e   e   e   e   e   e   e   e   e   e   e   e   e   e   e   e   e   e   e   e   e   e   e   e   e   e   e   e   e   e   e  
					e   e   e   e   e   e   e   e   e   e   e   e   e   e   e   e   e   e   e   e   e   e   e   e   e   e   e   e   e   e   e   e   e   e   e   e   e   e   e   e  