e  e  e  e  e  e  e  e  e  e
py e  e  e  e  e  py e  e  e
e  e  e  e  e  e  e  e  e  e
e  e  e  e  e  e  e  e  e  e
e  e  e  e  e  e  e  e  e  e
py e  e  e  e  e  py e  e  e
e  e  e  e  e  e  e  e  e  e
e  e  e  e  e  e  e  e  e  e
e  e  e  e  e  e  e  e  e  e
py e  e  e  e  e  py e  e  e
e  e  e  e  e  e  e  e  e  e
e  e  e  e  e  e  e  e  e  e
e  e  e  e  e  e  e  e  e  e
py e  e  e  e  e  py e  e  e
e  e  e  e  e  e  e  e  e  e
e  e  e  e  e  e  e  e  e  e
e  e  e  e  e  e  e  e  e  e
py e  e  e  e  e  py e  e  e
e  e  e  e  e  e  e  e  e  e
e  e  e  e  e  e  e  e  e  e
e  e  e  e  e  e  e  e  e  e
ts e  e  e  e  e  ts e  e  e
e  e  e  e  e  e  e  e  e  e
e  e  e  e  e  e  e  e  e  e
e  e  e  e  e  e  e  e  e  e
ts e  e  e  e  e  ts e  e  e
e  e  e  e  e  e  e  e  e  e
e  e  e  e  e  e  e  e  e  e
e  e  e  e  e  e  e  e  e  e
ts e  e  e  e  e  ts e  e  e
e  e  e  e  e  e  e  e  e  e
e  e  e  e  e  e  e  e  e  e
e  e  e  e  e  e  e  e  e  e
ts e  e  e  e  e  ts e  e  e
e  e  e  e  e  e  e  e  e  e
e  e  e  e  e  e  e  e  e  e
e  e  e  e  e  e  e  e  e  e
ts e  e  e  e  e  ts e  e  e
e  e  e  e  e  e  e  e  e  e
e  e  e  e  e  e  e  e  e  e