					w1  w1  w1  w1  w1  w1  w1  w1  w1  w1  w1  w1  w1  w1  w1  w1  w1  s   g   g   g   g   g   g   g   g   g   g   g   g   g   g   g   g   g   g   g   g   g   g  
					w1  w1  w1  w1  w1  w1  w1  w1  w1  w1  w1  w1  w1  w1  w1  w1  s   s   g   g   g   g   g   g   g   g   g   g   g   g   g   g   g   g   g   g   g   g   g   g  
					w1  w1  w1  w1  w1  w1  w1  w1  w1  w1  w1  w1  w1  w1  w1  s   s   g   g   g   g   g   g   g   g   g   g   g   g   g   g   g   g   g   g   g   g   g   g   g  
					w1  w1  w1  w1  w1  w1  w1  w1  w1  w1  w1  w1  w1  w1  s   s   g   g   g   g   g   g   g   g   g   g   g   g   g   g   g   g   g   g   g   g   g   g   g   g  
					w1  w1  w1  w1  w1  w1  w1  w1  w1  w1  w1  w1  w1  s   s   g   g   g   g   g   g   g   g   g   g   g   g   g   g   g   g   g   g   g   g   g   g   g   g   g  
					w1  w1  w1  w1  w1  w1  w1  w1  w1  w1  w1  w1  s   s   g   g   g   g   g   g   g   g   g   g   g   g   g   g   g   g   g   g   g   g   g   g   g   g   g   g  
					w1  w1  w1  w1  w1  w1  w1  w1  w1  w1  w1  s   s   g   g   g   g   g   g   g   g   g   g   g   g   g   g   g   g   g   g   g   g   g   g   g   g   g   g   g  
					w1  w1  w1  w1  w1  w1  w1  w1  w1  w1  s   s   g   g   g   g   g   g   g   g   g   g   g   g   g   g   g   g   g   g   g   g   g   g   g   g   g   g   g   g  
					w1  w1  w1  w1  w1  w1  w1  w1  w1  s   s   g   g   g   g   g   g   g   g   g   g   g   g   g   g   g   g   g   g   g   g   g   g   g   g   g   g   g   g   g  
					w1  w1  w1  w1  w1  w1  w1  w1  s   s   g   g   g   g   g   g   g   g   g   g   g   g   g   g   g   g   g   g   g   g   g   g   g   g   g   g   g   g   g   g  
					w1  w1  dc  dc  w1  w1  w1  s   s   g   g   g   g   g   g   g   g   g   g   g   g   g   g   g   g   g   g   g   g   g   g   g   g   g   g   g   g   g   g   g  
					w1  w1  dc  dc  w1  w1  s   s   g   g   g   g   g   g   g   g   g   g   g   g   g   g   g   g   g   g   g   g   g   g   g   g   g   g   g   g   g   g   g   g  
					w1  w1  dc  dc  w1  s   s   s   g   g   g   g   g   g   g   g   g   g   g   g   g   g   g   g   g   g   g   g   g   g   g   g   g   g   g   g   g   g   g   g  
					w1  w1  dc  dc  dc  r   r   r   r   r   r   r   r   r   r   r   r   r   r   r   r   r   r   r   r   r   r   r   r   r   r   r   r   r   r   g   g   g   g   g  
					w1  w1  dc  dc  dc  r   r   r   r   r   r   r   r   r   r   r   r   r   r   r   r   r   r   r   r   r   r   r   r   r   r   r   r   r   r   r   r   r   r   r  
					w1  w1  dc  dc  w1  s   s   s   g   g   g   g   g   g   r   r   g   g   g   g   g   g   g   g   g   g   g   g   g   g   g   g   g   r   r   r   r   r   r   r  
					w1  w1  dc  dc  w1  w1  s   s   g   g   g   g   g   g   r   r   g   g   g   g   g   g   g   g   g   g   g   g   g   g   g   g   g   r   r   g   g   g   g   g  
					w1  w1  dc  dc  w1  w1  s   s   g   g   g   g   g   g   r   r   g   g   g   g   g   g   g   g   g   g   g   g   g   g   g   g   g   r   r   g   g   g   g   g  
					w1  w1  w1  w1  w1  w1  w1  s   s   g   g   g   g   g   r   r   g   g   g   g   g   g   g   g   g   g   g   g   g   g   g   g   g   r   r   g   g   g   g   g  
					w1  w1  w1  w1  w1  w1  w1  s   s   g   g   g   g   g   r   r   g   g   g   g   g   g   g   g   g   g   g   g   g   g   g   g   g   r   r   g   g   g   g   g  
					w1  w1  w1  w1  w1  w1  w1  w1  s   s   g   g   g   g   r   r   g   g   g   g   g   g   g   g   g   g   g   g   g   g   g   g   g   r   r   g   g   g   g   g  
					w1  w1  w1  w1  w1  w1  w1  w1  s   s   g   g   g   g   r   r   g   g   g   g   g   g   g   g   g   g   g   g   g   g   g   g   g   r   r   g   g   g   g   g  
					w1  w1  w1  w1  w1  w1  w1  w1  w1  s   s   g   g   g   r   r   g   g   g   g   g   g   g   g   g   g   g   g   g   g   g   g   g   r   r   g   g   g   g   g  
					w1  w1  w1  w1  w1  w1  w1  w1  w1  s   s   g   g   g   r   r   r   r   r   r   r   r   r   r   r   r   r   r   r   r   r   r   r   r   r   g   g   s   s   s  
					w1  w1  w1  w1  w1  w1  w1  w1  w1  w1  s   s   g   g   r   r   r   r   r   r   r   r   r   r   r   r   r   r   r   r   r   r   r   r   r   s   s   s   w1  w1 
					w1  w1  w1  w1  w1  w1  w1  w1  w1  w1  s   s   g   g   g   g   g   g   g   g   r   r   g   g   s   s   s   s   s   s   s   s   w1  w1  w1  w1  w1  w1  w1  w1 
					w1  w1  w1  w1  w1  w1  w1  w1  w1  w1  w1  s   s   g   g   g   g   g   s   s   br  br  s   s   s   w1  w1  w1  w1  w1  w1  w1  w1  w1  w1  w1  w1  w1  w1  s  
					w1  w1  w1  w1  w1  w1  w1  w1  w1  w1  w1  s   s   s   s   s   s   s   s   w1  br  br  w1  w1  w1  w1  w1  w1  w1  w1  w1  w1  w1  s   s   s   s   s   s   s  
					w1  w1  w1  w1  w1  w1  w1  w1  w1  w1  w1  w1  w1  w1  w1  w1  w1  w1  w1  w1  br  br  w1  w1  w1  w1  s   s   s   s   s   s   s   s   g   g   g   g   g   g  
					w1  w1  w1  w1  w1  w1  w1  w1  w1  w1  w1  w1  w1  w1  w1  w1  w1  w1  w1  w1  br  br  s   s   s   s   s   g   g   g   g   g   g   g   g   g   g   g   g   g  
					w1  w1  w1  w1  w1  w1  w1  w1  w1  w1  w1  w1  w1  w1  w1  w1  w1  s   s   s   r   r   g   g   g   g   g   g   g   g   g   g   g   g   g   g   g   g   g   g  
					w1  w1  w1  w1  w1  w1  w1  w1  w1  w1  w1  w1  w1  w1  s   s   s   s   g   g   r   r   g   g   g   g   g   g   g   g   g   g   g   g   g   g   g   g   g   g  
					w1  w1  w1  w1  w1  w1  w1  w1  w1  w1  w1  w1  w1  w1  s   s   g   g   g   g   r   r   g   g   g   g   g   g   g   g   g   g   g   g   g   g   g   g   g   g  
					w1  w1  w1  w1  w1  w1  w1  w1  w1  w1  w1  w1  w1  w1  s   s   g   g   g   g   r   r   g   g   g   g   g   g   g   g   g   g   g   g   g   g   g   g   g   g  
					w1  w1  w1  w1  w1  w1  w1  w1  w1  w1  w1  w1  w1  w1  w1  s   s   g   g   g   r   r   g   g   g   g   g   g   g   g   g   g   g   g   g   g   g   g   g   g  
					w1  w1  w1  w1  w1  w1  w1  w1  w1  w1  w1  w1  w1  w1  w1  s   s   g   g   g   r   r   r   r   r   r   r   g   g   g   g   g   g   g   g   g   g   g   g   g  
					w1  w1  w1  w1  w1  w1  w1  w1  w1  w1  w1  w1  w1  w1  w1  w1  s   s   g   g   r   r   r   r   r   r   r   g   g   g   g   g   g   g   g   g   g   g   g   g  
					w1  w1  w1  w1  w1  w1  w1  w1  w1  w1  w1  w1  w1  w1  w1  w1  s   s   g   g   g   g   g   g   g   g   g   g   g   g   g   g   g   g   g   g   g   g   g   g  
					w1  w1  w1  w1  w1  w1  w1  w1  w1  w1  w1  w1  w1  w1  w1  w1  w1  s   s   g   g   g   g   g   g   g   g   g   g   g   g   g   g   g   g   g   g   g   g   g  
					w1  w1  w1  w1  w1  w1  w1  w1  w1  w1  w1  w1  w1  w1  w1  w1  w1  s   s   g   g   g   g   g   g   g   g   g   g   g   g   g   g   g   g   g   g   g   g   g  