e   py  e   e   py  e   e   py  e   e   py  e   e   py  e   e   py  e   e   py  e   e   py  e   e   py  e   e   py  e   e   py  e   e   py  e   e   py  e   e   
e   e   e   e   e   e   e   e   e   e   e   e   e   e   e   e   e   e   e   e   e   e   e   e   e   e   e   e   e   e   e   e   e   e   e   e   e   e   e   e   
e   py  e   e   e   e   e   e   e   e   e   e   e   e   e   e   e   e   e   e   e   e   e   e   e   e   e   e   e   e   e   e   e   e   e   e   e   py  e   e   
e   e   e   e   e   e   e   e   e   e   e   e   e   e   e   e   e   e   e   e   e   e   e   e   e   e   e   e   e   e   e   e   e   e   e   e   e   e   e   e   
e   py  e   e   e   e   e   e   e   e   e   e   e   e   e   e   e   e   e   e   e   e   e   e   e   e   e   e   e   e   e   e   e   e   e   e   e   py  e   e   
e   e   e   e   e   e   e   e   e   e   e   e   e   e   e   e   e   e   bp  e   e   e   e   e   e   e   e   e   e   e   e   e   e   e   e   e   e   e   e   e   
e   py  e   e   e   e   e   e   e   e   e   e   e   e   e   e   e   e   e   e   e   e   e   e   e   e   e   e   e   e   e   e   e   e   e   e   e   py  e   e   
e   e   e   e   e   e   e   e   e   e   e   e   e   e   e   e   e   e   e   e   e   e   e   e   e   e   e   e   e   e   e   e   e   e   e   e   e   e   e   e   
e   py  e   e   e   e   e   e   e   e   e   e   e   e   e   c2  e   e   e   e   e   e   e   e   e   e   e   e   e   e   e   e   e   e   e   e   e   py  e   e   
e   e   e   e   e   e   e   e   e   e   e   e   e   e   e   e   e   e   e   e   e   e   e   e   e   e   e   e   e   e   e   e   e   e   e   e   e   e   e   e   
e   py  e   e   e   e   e   e   e   e   e   e   e   e   e   e   e   e   e   e   e   e   e   e   e   e   e   e   e   e   e   e   e   e   e   e   e   py  e   e   
e   e   e   e   e   e   e   e   e   e   e   e   e   e   e   e   e   e   e   e   e   e   e   e   e   e   e   e   e   e   e   e   e   e   e   e   e   e   e   e   
e   py  e   e   e   e   e   e   e   c1  e   e   e   e   e   e   e   e   e   e   e   e   e   e   e   e   e   e   e   e   e   e   e   e   e   e   e   py  e   e   
e   e   e   e   e   e   e   e   e   e   e   e   e   e   e   e   e   e   e   e   e   e   e   e   e   e   e   e   e   e   e   e   e   e   e   e   e   e   e   e   
e   py  e   e   e   e   e   e   e   e   e   e   e   e   e   e   e   e   e   e   e   e   e   e   e   e   e   e   e   e   e   e   e   e   e   e   e   py  e   e   
e   e   e   e   e   e   e   e   e   e   e   e   e   e   e   e   e   e   e   e   e   e   e   e   e   e   e   e   e   e   e   e   e   e   e   e   e   e   e   e   
e   py  e   e   e   e   e   e   e   e   e   e   e   e   e   e   e   e   e   e   e   e   e   e   e   e   e   e   e   e   e   e   e   e   e   e   e   py  e   e   
e   e   e   e   e   e   e   e   e   e   e   e   e   e   e   e   e   e   e   e   e   e   e   e   e   e   e   e   e   e   e   e   e   e   e   e   e   e   e   e   
e   py  e   e   e   e   e   e   e   e   e   e   e   e   e   e   e   e   e   e   e   e   e   e   e   e   e   e   e   e   e   e   e   e   e   e   e   py  e   e   
e   e   e   e   e   e   e   e   e   e   c2  e   e   e   e   e   e   e   e   e   e   c2  e   e   e   e   c2  e   e   e   e   e   e   e   e   e   e   e   e   e   
e   py  e   e   e   e   e   e   e   e   e   e   e   e   e   e   e   e   e   e   e   e   e   e   e   e   e   e   e   e   e   e   e   e   e   e   e   py  e   e   
e   e   e   e   e   e   e   e   e   e   e   e   e   e   e   e   e   e   e   e   e   e   e   e   e   e   e   e   e   e   e   e   e   e   e   e   e   e   e   e   
e   py  e   e   e   e   e   e   e   e   e   e   e   e   e   e   c1  e   e   e   e   e   e   e   e   e   e   e   e   e   e   e   e   e   e   e   e   py  e   e   
e   e   e   e   e   e   e   e   e   e   e   e   e   e   e   e   e   e   e   e   e   e   e   e   e   e   e   e   e   e   e   e   e   e   e   e   e   e   e   e   
e   py  e   e   e   e   e   e   e   e   e   e   e   e   e   e   e   e   e   e   e   e   e   e   e   e   e   e   e   e   e   e   e   e   e   e   e   py  e   e   
e   e   e   e   e   e   e   e   e   e   e   e   e   e   e   e   e   e   e   e   e   e   e   e   e   e   e   e   e   e   e   e   e   e   e   e   e   e   e   e   
e   py  e   e   e   e   e   e   e   e   e   e   e   e   e   e   e   e   e   e   e   e   e   e   e   e   e   e   e   e   e   e   e   e   e   e   e   py  e   e   
e   e   e   e   e   e   e   e   e   e   e   e   e   e   e   e   e   e   e   e   e   e   e   e   e   e   e   e   e   e   e   e   e   e   e   e   e   e   e   e   
e   py  e   e   e   e   e   e   e   e   e   e   e   e   e   e   e   e   e   e   e   e   e   e   e   e   e   e   e   e   e   e   e   e   e   e   e   py  e   e   
e   e   e   e   e   e   e   e   e   e   e   e   e   e   e   e   e   e   e   e   e   e   e   e   e   e   e   e   e   e   e   e   e   e   e   e   e   e   e   e   
e   py  e   e   e   e   e   e   e   c1  e   e   e   e   e   e   e   e   e   e   e   e   e   e   e   e   c1  e   e   e   e   e   e   e   e   e   e   py  e   e   
e   e   e   e   e   e   e   e   e   e   e   e   e   e   e   e   e   e   e   e   e   e   e   e   e   e   e   e   e   e   e   e   e   e   e   e   e   e   e   e   
e   py  e   e   e   e   e   e   e   e   e   e   e   e   e   e   e   e   e   e   e   e   e   e   e   e   e   e   e   e   e   e   e   e   e   e   e   py  e   e   
e   e   e   e   e   e   e   e   e   e   e   e   e   e   e   e   e   e   e   e   e   e   e   e   e   e   e   e   e   e   e   e   e   e   e   e   e   e   e   e   
e   py  e   e   e   e   e   e   e   e   e   e   e   e   e   e   e   e   e   e   e   e   e   e   e   e   e   e   e   e   e   e   e   e   e   e   e   py  e   e   
e   e   e   e   e   e   e   e   e   e   e   e   e   e   e   e   e   e   e   e   e   e   e   e   e   e   e   e   e   e   e   e   e   e   e   e   e   e   e   e   
e   py  e   e   e   e   e   e   e   e   e   e   e   e   e   e   e   e   e   e   e   e   e   e   e   e   e   e   e   e   e   e   e   e   e   e   e   py  e   e   
e   e   e   e   e   e   e   e   e   e   e   e   e   e   e   e   e   e   e   e   e   e   e   e   e   e   e   e   e   e   e   e   e   e   e   e   e   e   e   e   
e   py  e   e   py  e   e   py  e   e   py  e   e   py  e   e   py  e   e   e   e   e   py  e   e   py  e   e   py  e   e   py  e   e   py  e   e   py  e   e   
e   e   e   e   e   e   e   e   e   e   e   e   e   e   e   e   e   e   e   e   e   e   e   e   e   e   e   e   e   e   e   e   e   e   e   e   e   e   e   e   