sb  sb  sb  sb  sb  sb  sb  sb  sb  sb  sb  sb  e   e   sb  sb  sb  sb  sb  sb  sb  sb  sb  sb  sb  
sb  sb  sb  sb  sb  sb  sb  sb  sb  sb  sb  sb  e   e   sb  sb  sb  sb  sb  sb  sb  sb  sb  sb  sb  
sb  sb  e   e   e   e   e   e   e   e   e   e   e   e   e   e   e   e   e   e   e   e   e   sb  sb  
sb  sb  e   e   s1  e   e   e   e   e   e   e   e   e   e   e   e   e   e   s2  e   e   e   sb  sb  
sb  sb  e   e   e   e   e   e   e   e   e   e   e   e   e   e   e   e   e   e   e   e   e   sb  sb  
sb  sb  e   e   e   e   e   e   e   e   e   e   e   e   e   e   e   e   e   e   e   e   e   sb  sb  
sb  sb  e   e   e   e   e   e   e   e   e   e   e   e   e   e   e   e   e   e   e   e   e   sb  sb  
sb  sb  e   e   e   e   e   e   e   e   e   e   e   e   e   e   e   e   e   e   e   e   e   sb  sb  
sb  sb  e   e   e   e   e   e   e   e   e   e   e   e   e   e   e   e   e   e   e   e   e   sb  sb  
sb  sb  e   e   e   e   e   e   e   e   e   e   e   e   e   e   e   e   e   e   e   e   e   sb  sb  
sb  sb  e   e   s3  e   e   e   e   e   e   e   e   e   e   e   e   e   e   s4  e   e   e   sb  sb  
sb  sb  e   e   e   e   e   e   e   e   e   e   e   e   e   e   e   e   e   e   e   e   e   sb  sb  
sb  sb  sb  sb  sb  sb  sb  sb  sb  sb  sb  sb  e   sb  sb  sb  sb  sb  sb  sb  sb  sb  sb  sb  sb  
sb  sb  sb  sb  sb  sb  sb  sb  sb  sb  sb  sb  sb  sb  sb  sb  sb  sb  sb  sb  sb  sb  sb  sb  sb  