bs  bs  bs  bs  bs  bs  bs  bs  bs  bs  bs  bs  bs  bs  bs  bs  bs  bs  bs  bs  bs  bs  bs  bs  bs  
bs  bs  bs  bs  bs  bs  bs  bs  bs  bs  bs  bs  bs  bs  bs  bs  bs  bs  bs  bs  bs  bs  bs  bs  bs  
bs  bs  e   e   e   e   e   e   e   e   e   n   n   n   n   e   e   e   e   e   e   e   e   bs  bs  
bs  bs  e   e   e   e   e   e   e   e   e   e   e   e   e   e   e   e   e   e   e   e   e   bs  bs  
bs  bs  e   e   e   e   e   e   e   e   e   e   e   e   e   e   e   e   e   e   e   e   e   bs  bs  
bs  bs  e   e   e   e   e   e   e   e   e   e   e   e   e   e   e   e   e   e   e   e   e   bs  bs  
bs  bs  e   e   e   e   e   e   e   e   e   e   e   e   e   e   e   e   e   e   e   e   e   bs  bs  
bs  bs  e   e   e   e   e   e   e   e   e   e   e   e   e   e   e   e   e   e   e   e   e   bs  bs  
bs  bs  e   e   e   e   e   e   e   e   e   e   e   e   e   e   e   e   e   e   e   e   e   bs  bs  
bs  bs  e   e   e   e   e   e   e   e   e   e   e   e   e   e   e   e   e   e   e   e   e   bs  bs  
bs  bs  e   e   e   e   e   e   e   e   e   e   e   e   e   e   e   e   e   e   e   e   e   bs  bs  
bs  bs  e   e   e   e   e   e   e   e   e   e   e   e   e   e   e   e   e   e   e   e   e   bs  bs  
bs  bs  bs  bs  bs  bs  bs  bs  bs  bs  bs  bs  e   e   bs  bs  bs  bs  bs  bs  bs  bs  bs  bs  bs  
bs  bs  bs  bs  bs  bs  bs  bs  bs  bs  bs  bs  e   e   bs  bs  bs  bs  bs  bs  bs  bs  bs  bs  bs  