e   e   e   e   e   e   e   e   e   e   e   cn  e   e   e   e   e   e   e   e   e   e   e   e   e   
e   e   e   e   e   e   e   e   e   e   e   e   e   e   e   e   e   e   e   e   e   e   e   e   e   
e   e   e   e   e   e   e   e   e   e   e   e   e   e   e   e   e   e   e   e   e   e   e   e   e   
e   e   e   e   e   e   e   e   e   e   e   e   dc  dc  e   e   e   e   e   e   e   e   e   e   e   
e   e   e   e   e   e   e   e   e   e   e   e   dc  dc  e   e   e   e   e   e   e   e   e   e   e   
e   e   e   e   e   e   e   e   e   e   e   e   dc  dc  e   e   e   e   e   e   e   e   e   e   e   
e   e   e   e   e   e   e   e   e   e   e   e   e   e   e   e   e   e   e   e   e   e   e   e   e   
e   e   e   e   e   e   e   e   e   e   e   e   e   e   e   e   e   e   e   e   e   e   e   e   e   
e   e   e   e   e   e   e   e   e   e   e   e   e   e   e   e   e   e   e   e   e   e   e   e   e   
e   e   e   e   e   e   e   e   e   e   e   e   e   e   e   e   e   e   e   e   e   e   e   e   e   
e   e   e   e   e   e   e   e   e   e   e   e   e   e   e   e   e   e   e   e   e   e   e   e   e   
e   e   e   e   e   e   e   e   e   e   e   e   e   e   e   e   e   e   e   e   e   e   e   e   e   
e   e   e   e   e   e   e   e   e   e   e   e   e   e   e   e   e   e   e   e   e   e   e   e   e   
e   e   e   e   e   e   e   e   e   e   e   e   e   e   e   e   e   e   e   e   e   e   e   e   e   