e   e   e   e   e   e   e   e   e   e   e   e   e   e   e   
e   e   e   e   e   e   e   e   e   e   e   e   e   e   e   
e   e   e   e   e   e   e   e   e   e   e   e   e   e   e   
e   e   e   e   e   e   c   e   c   e   e   e   e   e   e   
e   e   e   e   e   e   e   c   e   e   e   e   e   e   e   
e   e   e   e   e   e   e   e   e   e   e   e   e   e   e   
e   e   e   e   e   e   e   e   e   e   e   e   e   e   e   
e   e   e   e   e   fl  fl  fl  fl  fl  e   e   e   e   e   
e   e   e   e   e   fl  e   e   e   fl  e   e   e   e   e   
e   e   e   e   e   fl  e   e   e   fl  e   e   e   e   e   
e   e   e   e   e   fl  e   e   e   fl  e   e   e   e   e   
e   e   e   e   e   fl  e   e   e   fl  e   e   e   e   e   
e   e   e   e   e   fl  e   e   e   fl  e   e   e   e   e   
e   e   e   e   e   fl  e   e   e   fl  e   e   e   e   e   
e   e   e   e   e   fl  fl  fl  fl  fl  e   e   e   e   e   
e   e   e   e   e   e   e   e   e   e   e   e   e   e   e   
e   e   e   e   e   e   e   e   e   e   e   e   e   e   e   
e   e   e   e   e   e   e   e   e   e   e   e   e   e   e   
e   e   e   e   e   e   e   e   e   e   e   e   e   e   e   
e   e   e   e   e   e   e   e   e   e   e   e   e   e   e   
e   e   e   e   e   e   e   e   e   e   e   e   e   e   e   
e   e   e   si  e   e   e   si  e   e   e   si  e   e   e   
e   e   e   e   e   e   e   e   e   e   e   e   e   e   e   
e   e   e   e   e   e   e   e   e   e   e   e   e   e   e   
e   e   e   e   e   e   e   e   e   e   e   e   e   e   e   
