e   t   e   t   e   t   e   t   t   e   e   e   e   e   t   t   e   t   e   t   e   t   e   e   e   
e   t   e   e   e   e   e   e   e   e   e   ca  e   e   e   e   e   e   e   e   e   t   e   e   e   
e   t   e   e   e   e   e   e   e   e   e   e   e   e   e   e   e   e   e   e   e   t   e   e   e   
e   t   e   e   e   e   e   e   e   e   e   e   e   e   e   e   e   e   e   e   e   t   e   e   e   
e   t   e   e   e   e   e   e   e   e   e   e   e   e   e   e   e   e   e   e   e   t   e   e   e   
e   t   e   e   e   e   e   e   e   e   e   e   e   e   e   e   e   e   e   e   e   t   e   e   e   
e   t   e   e   e   e   e   e   e   e   e   e   e   e   e   e   e   e   e   e   e   t   e   e   e   
e   t   e   e   e   e   e   e   e   e   e   e   e   e   e   e   e   e   e   e   e   t   e   e   e   
e   t   e   e   e   e   e   e   e   e   e   e   e   e   e   e   e   e   e   e   e   t   e   e   e   
e   t   e   e   e   e   e   e   e   e   e   e   e   e   e   e   e   e   e   e   e   t   e   e   e   
e   t   e   e   e   e   e   e   e   e   e   e   e   e   e   e   e   e   e   e   e   t   e   e   e   
e   t   e   e   e   e   e   e   e   e   e   e   e   e   e   e   e   e   e   e   e   t   e   e   e   
e   t   e   t   e   t   e   t   e   t   e   t   e   t   e   t   e   t   e   t   e   t   e   e   e   
e   e   e   e   e   e   e   e   e   e   e   e   e   e   e   e   e   e   e   e   e   e   e   e   e   