							g  g  g  g  g  g  g  g  g  g  g  g  g  g  g  g  g  g  g  g  g  g  g  g  g  g  g  g  g  g  g  g  g  g  g  g  g  g  g  g 
						    g  g  g  g  g  g  g  g  g  g  g  g  g  g  g  g  g  g  g  g  g  g  g  g  g  g  g  g  g  g  g  g  g  g  g  g  g  g  g  g 
						    g  g  g  g  g  g  g  g  g  g  g  g  g  g  g  g  g  g  g  g  g  g  g  g  g  g  g  g  g  g  g  g  g  g  g  g  g  g  g  g 
						    g  g  g  g  g  g  g  g  g  g  g  g  g  g  g  g  g  g  g  g  g  g  g  g  g  g  g  g  g  g  g  g  g  g  g  g  g  g  g  g 
						    g  g  g  g  g  g  g  g  g  g  g  g  g  g  g  g  g  g  g  g  g  g  g  g  g  g  g  g  g  g  g  g  g  g  g  g  g  g  g  g 
						    g  g  g  g  g  g  g  g  g  g  g  g  g  g  g  g  g  g  g  g  g  g  g  g  g  g  g  g  g  g  g  g  g  g  g  g  g  g  g  g 
						    g  g  g  g  g  g  g  g  g  g  g  g  g  g  g  g  g  g  g  g  g  g  g  g  g  g  g  g  g  g  g  g  g  g  g  g  g  g  g  g 
						    g  g  g  g  r  r  r  r  r  r  r  r  r  r  r  r  r  r  r  r  r  r  r  r  r  r  r  r  r  r  r  r  r  r  r  r  r  r  r  r 
						    g  g  g  g  r  r  r  r  r  r  r  r  r  r  r  r  r  r  r  r  r  r  r  r  r  r  r  r  r  r  r  r  r  r  r  r  r  r  r  r 
						    g  g  g fl  r  r fl  g  g  g fl  g  g  g fl  g  g  g fl  r  r fl  g  g  g fl  g  g  g fl  g  g  g fl  r  r fl  g  g  g 
						    g  g  g  g  r  r  g  g  g  g  g  g  g  g  g  g  g  g  g  r  r  g  g  g  g  g  g  g  g  g  g  g  g  g  r  r  g  g  g  g 
						    g  g  g  g  r  r  g  g  g  g  g  g  g  g  g  g  g  g  g  r  r  g  g  g  g  g  g  g  g  g  g  g  g  g  r  r  g  g  g  g 
						    g  g  g  g  r  r  g  g  g  g  g  g  g  g  g  g  g  g  g  r  r  g  g  g  g  g  g  g  g  g  g  g  g  g  r  r  g  g  g  g 
						    g  g  g  g  r  r  g  g  g  g  g  g  g  g  g  g  g  g  g  r  r  g  g  g  g  g  g  g  g  g  g  g  g  g  r  r  g  g  g  g 
						    g  g  g fl  r  r fl  g  g  g  g  g  g  g fl  g  g  g fl  r  r fl  g  g  g fl  g  g  g  g  g  g  g fl  r  r fl  g  g  g 
						    g  g  g  g  r  r  g  g  g  g  g  g  g  g  g  r  r  r  r  r  r  r  r  r  r  g  g  g  g  g  g  g  g  g  r  r  g  g  g  g 
						    g  g  g  g  r  r  g  g  g  g  g  g  g  g  g  r  r  r  r  r  r  r  r  r  r  g  g  g  g  g  g  g  g  g  r  r  g  g  g  g 
						    g  g  g  g  r  r  g  g  g  g  g  g  g  g  g  r  r  g fl w1 w1 fl  g  r  r  g  g  g  g  g  g  g  g  g  r  r  g  g  g  g 
						    g  g  g fl  r  r fl  g  g  g fl  g  g  g fl  r  r fl w1 w2 w2 w1 fl  r  r fl  g  g  g fl  g  g  g fl  r  r fl  g  g  g 
						    g  g  g  g  r  r  r  r  r  r  r  r  r  r  r  r  r w1 w2 w2 w2 w2 w1  r  r  r  r  r  r  r  r  r  r  r  r  r  g  g  g  g 
						    g  g  g  g  r  r  r  r  r  r  r  r  r  r  r  r  r w1 w2 w2 w2 w2 w1  r  r  r  r  r  r  r  r  r  r  r  r  r  g  g  g  g 
						    g  g  g fl  r  r fl  g  g  g  g  g  g  g fl  r  r fl w1 w2 w2 w1 fl  r  r fl  g  g  g  g  g  g  g fl  r  r fl  g  g  g 
						    g  g  g  g  r  r  g  g  g  g  g  g  g  g  g  r  r  g fl w1 w1 fl  g  r  r  g  g  g  g  g  g  g  g  g  r  r  g  g  g  g 
						    g  g  g  g  r  r  g  g  g  g  g  g  g  g  g  r  r  r  r  r  r  r  r  r  r  g  g  g  g  g  g  g  g  g  r  r  g  g  g  g 
						    g  g  g  g  r  r  g  g  g  g  g  g  g  g  g  r  r  r  r  r  r  r  r  r  r  g  g  g  g  g  g  g  g  g  r  r  g  g  g  g 
						    g  g  g fl  r  r fl  g  g  g  g  g  g  g fl  g  g  g fl  r  r fl  g  g  g fl  g  g  g  g  g  g  g fl  r  r fl  g  g  g 
						    g  g  g  g  r  r  g  g  g  g  g  g  g  g  g  g  g  g  g  r  r  g  g  g  g  g  g  g  g  g  g  g  g  g  r  r  g  g  g  g 
						    g  g  g  g  r  r  g  g  g  g  g  g  g  g  g  g  g  g  g  r  r  g  g  g  g  g  g  g  g  g  g  g  g  g  r  r  g  g  g  g 
						    g  g  g  g  r  r  g  g  g  g  g  g  g  g  g  g  g  g  g  r  r  g  g  g  g  g  g  g  g  g  g  g  g  g  r  r  g  g  g  g 
						    g  g  g fl  r  r fl  g  g  g  g  g  g  g  g  g  g  g fl  r  r fl  g  g  g  g  g  g  g  g  g  g  g fl  r  r fl  g  g  g 
						    g  g  g  g  r  r  g  g  g  g  g  g  g  g  g  g  g  g  g  r  r  g  g  g  g  g  g  g  g  g  g  g  g  g  r  r  g  g  g  g 
						    g  g  g  g  r  r  g  g  g  g  g  g  g  g  g  g  g  g  g  r  r  g  g  g  g  g  g  g  g  g  g  g  g  g  r  r  g  g  g  g 
						    g  g  g  g  r  r  g  g  g  g  g  g  g  g  g  g  g  g  g  r  r  g  g  g  g  g  g  g  g  g  g  g  g  g  r  r  g  g  g  g 
						    g  g  g fl  r  r fl  g  g  g fl  g  g  g fl  g  g  g fl  r  r fl  g  g  g fl  g  g  g fl  g  g  g fl  r  r fl  g  g  g 
						    g  g  g  g  r  r  r  r  r  r  r  r  r  r  r  r  r  r  r  r  r  r  r  r  r  r  r  r  r  r  r  r  r  r  r  r  g  g  g  g 
						    g  g  g  g  r  r  r  r  r  r  r  r  r  r  r  r  r  r  r  r  r  r  r  r  r  r  r  r  r  r  r  r  r  r  r  r  g  g  g  g 
						    g  g  g fl  g  g fl  g  g  g fl  g  g  g fl  g  g  g fl  r  r fl  g  g  g fl  g  g  g fl  g  g  g fl  g  g fl  g  g  g 
						    g  g  g  g  g  g  g  g  g  g  g  g  g  g  g  g  g  g  g  r  r  g  g  g  g  g  g  g  g  g  g  g  g  g  g  g  g  g  g  g 
						    g  g  g  g  g  g  g  g  g  g  g  g  g  g  g  g  g  g  g  r  r  g  g  g  g  g  g  g  g  g  g  g  g  g  g  g  g  g  g  g 
						    g  g  g  g  g  g  g  g  g  g  g  g  g  g  g  g  g  g  g  r  r  g  g  g  g  g  g  g  g  g  g  g  g  g  g  g  g  g  g  g