					s  s  s  s  s  s  s  s  s  s  s  s  s  s  s  s  s  s  s  s  s  s  s  s  s  s  w2 w1 w1 w2 s  s  s  s  s  s  s  s  s  s 
					s  s  s  s  s  s  s  s  s  s  s  s  s  s  s  s  s  s  s  s  s  s  s  s  s  w2 w1 w1 w2 s  s  s  s  s  s  s  s  s  s  s 							
					s  s  s  s  s  s  s  s  s  s  s  s  s  s  s  s  s  s  s  s  s  s  s  s  w2 w1 w1 w2 s  s  s  s  s  s  s  s  s  s  s  s
					s  s  s  s  s  s  s  s  s  s  s  s  s  s  s  s  s  s  s  s  s  s  s  s  w2 w1 w1 w2 s  s  s  s  s  s  s  s  s  s  s  s 
					g  g  g  g  g  s  s  s  s  s  s  s  s  s  s  s  s  s  s  s  s  s  s  s  w2 w1 w1 w2 s  s  s  s  s  s  s  s  s  s  s  s 
					g  g  g  g  g  s  s  s  s  s  s  s  s  s  s  s  s  s  s  s  s  s  s  w2 w1 w1 w2 s  s  s  s  s  s  s  s  s  s  s  s  s 
					r  r  r  r  r  r  r  r  r  r  r  r  r  r  r  r  r  r  r  r  r  r  r  r  r  r  r  r  r  r  r  r  r  r  r  r  r  r  r  r 							
					r  r  r  r  r  r  r  r  r  r  r  r  r  r  r  r  r  r  r  r  r  r  r  r  r  r  r  r  r  r  r  r  r  r  r  r  r  r  r  r
					g  g  g  g  g  s  s  s  s  s  s  s  s  s  s  s  s  s  s  s  r  r  s  s  s  w2 w1 w1 w2 s  s  s  s  s  s  s  s  s  s  s 
					g  g  g  g  g  s  s  s  s  s  s  s  s  s  s  s  s  s  s  s  r  r  s  s  s  s  w2 w1 w1 w2 s  s  s  s  s  s  s  s  s  s 
					s  s  s  s  s  s  s  s  s  s  s  s  s  s  s  s  s  s  s  s  r  r  s  s  s  s  w2 w1 w1 w2 s  s  s  s  s  s  s  s  s  s 
					s  s  s  s  s  s  s  s  s  s  s  s  s  s  s  s  s  s  s  s  r  r  s  s  s  s  w2 w1 w1 w2 s  s  s  s  s  s  s  s  s  s 
					s  s  s  s  s  s  s  s  s  s  s  s  s  s  s  s  s  s  s  s  r  r  s  s  s  s  w2 w1 w1 w2 s  s  s  s  s  s  s  s  s  s 
					s  s  s  s  s  s  s  s  s  s  s  s  s  s  s  s  s  s  s  s  r  r  s  s  s  s  w2 w1 w1 w2 s  s  s  s  s  s  s  s  s  s 
					s  s  s  s  s  s  s  s  s  s  s  s  s  s  s  s  s  s  s  s  r  r  s  s  s  s  w2 w1 w1 w2 s  s  s  s  s  s  s  s  s  s 
					s  s  s  s  s  s  s  s  s  s  s  s  s  s  s  s  s  s  s  s  r  r  s  s  s  w2 w1 w1 w2 s  s  s  s  s  s  s  s  s  s  s 
					s  s  s  s  s  s  s  s  s  s  s  s  s  s  s  s  s  s  s  s  r  r  s  s  s  w2 w1 w1 w2 s  s  s  s  s  s  s  s  s  s  s 
					s  s  s  s  s  s  s  s  s  s  s  s  s  s  s  s  s  s  s  s  r  r  s  s  s  w2 w1 w1 w2 s  s  s  s  s  s  s  s  s  s  s 
					s  s  s  s  s  s  s  s  s  s  s  s  s  s  s  s  s  s  s  s  r  r  s  s  s  w2 w1 w1 w2 s  s  s  s  s  s  s  s  s  s  s 
					s  s  s  s  s  s  s  s  s  s  s  s  s  s  s  s  s  s  s  s  r  r  s  s  w2 w1 w1 w2 s  s  s  s  s  s  s  s  s  s  s  s 
					s  s  s  s  s  s  s  s  s  s  s  s  s  s  s  s  s  s  s  s  r  r  s  s  w2 w1 w1 w2 s  s  s  s  s  s  s  s  s  s  s  s 
					s  s  s  s  s  s  s  s  s  s  s  s  s  s  s  s  s  s  s  s  r  r  s  s  w2 w1 w1 w2 s  s  s  s  s  s  s  s  s  s  s  s 
					s  s  s  s  s  s  s  s  s  s  s  s  s  s  s  s  s  s  s  s  r  r  s  s  w2 w1 w1 w2 s  s  s  s  s  s  s  s  s  s  s  s 
					s  s  s  s  s  s  s  s  s  s  s  s  s  s  s  s  s  s  s  s  r  r  s  w2 w1 w1 w2 s  s  s  s  s  s  s  s  s  s  s  s  s 
					s  s  s  s  s  s  s  s  s  s  s  s  s  s  s  s  s  s  s  s  r  r  s  w2 w1 w1 w2 s  s  s  s  s  s  s  s  s  s  s  s  s 
					s  s  s  s  s  s  s  s  s  s  s  s  s  s  s  s  s  s  s  s  r  r  s  w2 w1 w1 w2 s  s  s  s  s  s  s  s  s  s  s  s  s 
					s  s  s  s  s  s  s  s  s  s  s  s  s  s  s  s  s  s  s  s  r  r  s  w2 w1 w1 w2 s  s  s  s  s  s  s  s  s  s  s  s  s 
					s  s  s  s  s  s  s  s  s  s  s  s  s  s  s  s  s  s  s  s  r  r  s  w2 w1 w1 w2 s  s  s  s  s  s  s  s  s  s  s  s  s 
					s  s  s  s  s  s  s  s  s  s  s  s  s  s  s  s  s  s  s  s  r  r  w2 w1 w1 w2 s  s  s  s  s  s  s  s  s  s  s  s  s  s 
					s  s  s  s  s  s  s  s  s  s  s  s  s  s  s  s  s  s  s  s  r  r  w2 w1 w1 w2 s  s  s  s  s  s  s  s  s  s  s  s  s  s 
					s  s  s  s  s  s  s  s  s  s  s  s  s  s  s  s  s  s  s  s  r  r  w2 w1 w1 w2 s  s  s  s  s  s  s  s  s  s  s  s  s  s 
					s  s  s  s  s  s  s  s  s  s  s  s  s  s  s  s  s  s  s  s  r  r  w2 w1 w1 w2 s  s  s  s  s  s  s  s  s  s  s  s  s  s 
					s  s  s  s  s  s  s  s  s  s  s  s  s  s  s  s  s  s  s  s  r  r  w1 w1 w2 s  s  s  s  s  s  s  s  s  s  s  s  s  s  s 
					s  s  s  s  s  s  s  s  s  s  s  s  s  s  s  s  s  s  s  s  r  r  w1 w1 w2 s  s  s  s  s  s  s  s  s  s  s  s  s  s  s 
					s  s  s  s  s  s  s  s  s  s  s  s  s  s  s  s  s  s  s  s  r  r  w1 w2 s  s  s  s  s  s  s  s  s  s  s  s  s  s  s  s 						
					s  s  s  s  s  s  s  s  s  s  s  s  s  s  s  s  s  s  s  s  r  r  w1 w2 s  s  s  s  s  s  s  s  s  s  s  s  s  s  s  s 
					s  s  s  s  s  s  s  s  s  s  s  s  s  s  s  s  s  s  s  w2 r  r  w2 s  s  s  s  s  s  s  s  s  s  s  s  s  s  s  s  s 
					s  s  s  s  s  s  s  s  s  s  s  s  s  s  s  s  s  s  s  w2 r  r  w2 s  s  s  s  s  s  s  s  s  s  s  s  s  s  s  s  s 
					s  s  s  s  s  s  s  s  s  s  s  s  s  s  s  s  s  s  w2 w1 r  r  s  s  s  s  s  s  s  s  s  s  s  s  s  s  s  s  s  s 
					s  s  s  s  s  s  s  s  s  s  s  s  s  s  s  s  s  s  w2 w1 r  r  s  s  s  s  s  s  s  s  s  s  s  s  s  s  s  s  s  s 