							  e  t  e  e  t  e  e  t  e  e  t  e  e  t  e  e  t  e  e  t  e  e  t  e  e  t  e  e  t  e  e  t  e  e  t  e  e  t  e  e 
							  e  e  e  e  e  e  e  e  e  e  e  e  e  e  e  e  e  e  e  e  e  e  e  e  e  e  e  e  e  e  e  e  e  e  e  e  e  e  e  e 
							  e  e  e  e  e  e  e  e  e  e  e  e  e  e  e  e  e  e  e  e  e  e  e  e  e  e  e  e  e  e  e  e  e  e  e  e  e  e  e  e 
							  e  e  e  e  e  e  e  e  e  c  e  e  e  e  e  e  e  e  e  e  e  e  e  e  e  e  e  e  e  e  e  e  e  e  e  e  e  e  e  e 
							  e  e  e  e  e  e  e  e  e  e  e  e  e  e  e  e  e  e  e  e  e  e  e  e  e  e  e  e  e  e  e  e  e  e  e  e  e  e  e  e 
							  e  e  e  e  e  e  e  e  e  e  e  e  e  e  e  e  e  e  e  e  e  e  e  e  e  e  e  e  e  e  e  e  e  e  e  e  e  e  e  e 
							  e  e  e  e  e  e  e  e  e  e  e  e  e  e  e  e  e  e  e  e  e  e  e  e  e  e  e  e  e  e  e  e  e  e  e  e  e  e  e  e 
							  e  t  e  e  t  e  e  t  e  e  t  e  e  t  e  e  t  e  e  t  e  e  t  e  e  t  e  e  t  e  e  t  e  e  t  e  e  t  e  e 
							  e  e  e  e  e  e  e  e  e  e  e  e  e  e  e  e  e  e  e  e  e  e  e  e  e  e  e  e  e  e  e  e  e  e  e  e  e  e  e  e 
							  e  e  e  e  e  e  e  e  e  e  e  e  e  e  e  e  e  e  e  e  e  e  e  e  e  e  e  e  e  e  e  e  e  e  e  e  e  e  e  e