					sn sn sn sn sn sn sn sn sn sn sn sn sn sn sn sn w2 w1 w1 w2 r  r  sn sn sn sn sn sn sn sn sn sn sn sn sn sn sn sn sn sn
					sn sn sn sn sn sn sn sn sn sn sn sn sn sn sn sn w2 w1 w1 w2 r  r  sn sn sn sn sn sn sn sn sn sn sn sn sn sn sn sn sn sn
					sn sn sn sn sn sn sn sn sn sn sn sn sn sn sn sn w2 w1 w1 w2 r  r  sn sn sn sn sn sn sn sn sn sn sn sn sn sn sn sn sn sn
					sn sn sn sn sn sn sn sn sn sn sn sn sn sn sn sn w2 w1 w1 w2 r  r  sn sn sn sn sn sn sn sn sn sn sn sn sn sn sn sn sn sn
					sn sn sn sn sn sn sn sn sn sn sn sn sn sn sn sn w2 w1 w1 w2 r  r  sn sn sn sn sn sn sn sn sn sn sn sn sn sn sn sn sn sn
					sn sn sn sn sn sn sn sn sn sn sn sn sn sn sn sn w2 w1 w1 w2 r  r  sn sn sn sn sn sn sn sn sn sn sn sn sn sn sn sn sn sn
					sn sn sn sn sn sn sn sn sn sn sn sn sn sn sn sn w2 w1 w1 w2 r  r  sn sn sn sn sn sn sn sn sn sn sn sn sn sn sn sn sn sn
					sn sn sn sn sn sn sn sn sn sn sn sn sn sn sn sn w2 w1 w1 w2 r  r  sn sn sn sn sn sn sn sn sn sn sn sn sn sn sn sn sn sn
					sn sn sn sn sn sn sn sn sn sn sn sn sn sn sn sn w2 w1 w1 w2 r  r  sn sn sn sn sn sn sn sn sn sn sn sn sn sn sn sn sn sn
					sn sn sn sn sn sn sn sn sn sn sn sn sn sn sn sn w2 w1 w1 w2 r  r  sn sn sn sn sn sn sn sn sn sn sn sn sn sn sn sn sn sn
					sn sn sn sn sn sn sn sn sn sn sn sn sn sn sn sn w2 w1 w1 w2 r  r  sn sn sn sn sn sn sn sn sn sn sn sn sn sn sn sn sn sn
					sn sn sn sn sn sn sn sn sn sn sn sn sn sn sn sn w2 w1 w1 w2 r  r  sn sn sn sn sn sn sn sn sn sn sn sn sn sn sn sn sn sn
					sn sn sn sn sn sn sn sn sn sn sn sn sn sn sn sn w2 w1 w1 w2 r  r  sn sn sn sn sn sn sn sn sn sn sn sn sn sn sn sn sn sn
					sn sn sn sn sn sn sn sn sn sn sn sn sn sn sn w2 w1 w1 w1 w2 r  r  sn sn sn sn sn sn sn sn sn sn sn sn sn sn sn sn sn sn
					sn sn sn sn sn sn sn sn sn sn sn sn sn sn w2 w1 w1 w1 w1 w2 r  r  sn sn sn sn sn sn sn sn sn sn sn sn sn sn sn sn sn sn
					sn sn sn sn sn sn sn sn sn sn sn sn sn w2 w1 w1 w1 w1 w2 sn r  r  sn sn sn sn sn sn sn sn sn sn sn sn sn sn sn sn sn sn
					sn sn sn sn sn sn sn sn sn sn sn sn w2 w1 w1 w1 w1 w2 sn sn r  r  sn sn sn sn sn sn sn sn sn sn sn sn sn sn sn sn sn sn
					r  r  r  r  r  r  r  r  r  r  r  r  r  r  r  r  r  r  r  r  r  r  sn sn sn sn sn sn sn sn sn sn sn sn sn sn sn sn sn sn
					r  r  r  r  r  r  r  r  r  r  r  r  r  r  r  r  r  r  r  r  r  r  sn sn sn sn sn sn sn sn sn sn sn sn sn sn sn sn sn sn
					w2 w2 w2 w2 w2 w2 w2 w2 w2 w2 w2 w1 w1 w1 w2 sn sn sn sn sn sn sn sn sn sn sn sn sn sn sn sn sn sn sn sn sn sn sn sn sn
					w1 w1 w1 w1 w1 w1 w1 w1 w1 w1 w1 w1 w1 w2 sn sn sn sn sn sn sn sn sn sn sn sn sn sn sn sn sn sn sn sn sn sn sn sn sn sn
					w1 w1 w1 w1 w1 w1 w1 w1 w1 w1 w1 w1 w2 sn sn sn sn sn sn sn sn sn sn sn sn sn sn sn sn sn sn sn sn sn sn sn sn sn sn sn
					w2 w2 w2 w2 w2 w2 w2 w2 w2 w2 w2 w2 sn sn sn sn sn sn sn sn sn sn sn sn sn sn sn sn sn sn sn sn sn sn sn sn sn sn sn sn
					sn sn sn sn sn sn sn sn sn sn sn sn sn sn sn sn sn sn sn sn sn sn sn sn sn sn sn sn sn sn sn sn sn sn sn sn sn sn sn sn
					sn sn sn sn sn sn sn sn sn sn sn sn sn sn sn sn sn sn sn sn sn sn sn sn sn sn sn sn sn sn sn sn sn sn sn sn sn sn sn sn
					sn sn sn sn sn sn sn sn sn sn sn sn sn sn sn sn sn sn sn sn sn sn sn sn sn sn sn sn sn sn sn sn sn sn sn sn sn sn sn sn
					sn sn sn sn sn sn sn sn sn sn sn sn sn sn sn sn sn sn sn sn sn sn sn sn sn sn sn sn sn sn sn sn sn sn sn sn sn sn sn sn
					sn sn sn sn sn sn sn sn sn sn sn sn sn sn sn sn sn sn sn sn sn sn sn sn sn sn sn sn sn sn sn sn sn sn sn sn sn sn sn sn
					sn sn sn sn sn sn sn sn sn sn sn sn sn sn sn sn sn sn sn sn sn sn sn sn sn sn sn sn sn sn sn sn sn sn sn sn sn sn sn sn
					sn sn sn sn sn sn sn sn sn sn sn sn sn sn sn sn sn sn sn sn sn sn sn sn sn sn sn sn sn sn sn sn sn sn sn sn sn sn sn sn
					sn sn sn sn sn sn sn sn sn sn sn sn sn sn sn sn sn sn sn sn sn sn sn sn sn sn sn sn sn sn sn sn sn sn sn sn sn sn sn sn
					sn sn sn sn sn sn sn sn sn sn sn sn sn sn sn sn sn sn sn sn sn sn sn sn sn sn sn sn sn sn sn sn sn sn sn sn sn sn sn sn
					sn sn sn sn sn sn sn sn sn sn sn sn sn sn sn sn sn sn sn sn sn sn sn sn sn sn sn sn sn sn sn sn sn sn sn sn sn sn sn sn
					sn sn sn sn sn sn sn sn sn sn sn sn sn sn sn sn sn sn sn sn sn sn sn sn sn sn sn sn sn sn sn sn sn sn sn sn sn sn sn sn
					sn sn sn sn sn sn sn sn sn sn sn sn sn sn sn sn sn sn sn sn sn sn sn sn sn sn sn sn sn sn sn sn sn sn sn sn sn sn sn sn
					sn sn sn sn sn sn sn sn sn sn sn sn sn sn sn sn sn sn sn sn sn sn sn sn sn sn sn sn sn sn sn sn sn sn sn sn sn sn sn sn
					sn sn sn sn sn sn sn sn sn sn sn sn sn sn sn sn sn sn sn sn sn sn sn sn sn sn sn sn sn sn sn sn sn sn sn sn sn sn sn sn
					sn sn sn sn sn sn sn sn sn sn sn sn sn sn sn sn sn sn sn sn sn sn sn sn sn sn sn sn sn sn sn sn sn sn sn sn sn sn sn sn
					sn sn sn sn sn sn sn sn sn sn sn sn sn sn sn sn sn sn sn sn sn sn sn sn sn sn sn sn sn sn sn sn sn sn sn sn sn sn sn sn
					sn sn sn sn sn sn sn sn sn sn sn sn sn sn sn sn sn sn sn sn sn sn sn sn sn sn sn sn sn sn sn sn sn sn sn sn sn sn sn sn